################
# #    @  L    #
# #    S       #
# #    SL    # #
# #          # #
# #          # #
# #          # #
# #          # #
# #          # #
# #    X     # #
# #          # #
# #          # #
# #          # #
# ############ #
#              #
################
