################
# #    @  L    #
# #    L       #
# #    LL    # #
# #          # #
# #          # #
# #          # #
# #          # #
# #          # #
# #    X     # #
# #          # #
# #   C      # #
# #          # #
# ############ #
#              #
################
