################
# #    @  D    #
# #    X       #
# #          # #
# #          # #
# #          # #
# #          # #
# #          # #
# #          # #
# #    X     # #
# #          # #
# #          # #
# #          # #
# ############ #
#              #
################
