################
# #          @ #
# #            #
# #          #X#
# #          # #
# #          # #
# #          # #
# #          # #
# #          # #
# #          # #
# #          # #
# #          # #
# #          # #
# ############ #
#              #
################
