################
#  C    S      #
#              #
#              #
#         D    #
#   G  @      V#
###    X     ###
#L     GGG    G#
###          ###
#              #
#              #
#              #
#              #
#              #
#              #
################