################
#              #
#              #
#   C          #
#         D    #
#   GG @      V#
###    X     ###
#L     GGG    G#
###          ###
#DDDDDDDDDDD   #
#    DDDDDDDDDD#
#              #
#              #
#C            C#
#CC   #L#    CC#
################